30,30
19,19,23,23,23,23,23,23,23,23,23,23,23,23,23,23,23,23,23,23,23,23,23,23,23,23,23,23,23,23
19,19,23,23,23,23,23,69,69,69,69,69,69,69,69,23,23,23,23,23,23,23,23,23,23,23,23,23,23,23
19,19,63,63,63,63,63,63,63,63,63,63,63,63,63,63,63,63,63,63,63,63,63,63,63,63,63,63,19,19
19,19,63,63,63,63,63,63,63,63,63,63,63,63,63,63,63,63,63,63,63,63,63,63,63,63,63,63,19,19
19,19,63,63,63,63,63,63,63,63,63,63,63,63,63,63,63,63,63,63,63,63,63,63,63,63,63,63,19,19
19,19,63,63,63,63,63,63,63,63,63,63,63,63,63,63,63,63,63,63,63,63,63,63,63,63,63,63,19,19
19,19,63,63,63,63,63,63,63,63,63,63,63,63,63,63,63,63,63,63,63,63,63,63,63,63,63,63,19,19
19,19,63,63,63,63,63,63,63,63,63,63,63,63,63,63,63,63,63,63,63,63,63,63,63,63,63,63,19,19
19,19,63,63,63,63,63,63,63,63,63,63,63,63,63,63,63,63,63,63,63,63,63,63,63,63,63,63,19,19
19,19,63,63,63,63,63,63,63,63,63,63,63,63,63,63,63,63,63,63,63,63,63,63,63,63,63,63,19,19
19,19,63,63,63,63,63,51,51,63,63,63,63,63,63,63,63,63,63,63,63,63,63,63,63,63,63,63,19,19
19,19,63,63,63,63,63,51,51,185,63,63,63,63,63,63,63,63,63,63,63,63,63,63,63,63,63,63,19,19
19,19,63,63,63,63,63,63,51,51,63,51,63,63,63,63,63,63,63,63,63,63,63,63,63,63,63,63,19,19
19,19,63,63,63,63,63,63,51,51,51,51,63,63,63,63,63,63,63,63,63,63,63,63,63,63,63,63,19,19
19,19,63,63,63,63,63,63,63,63,63,63,63,63,63,63,63,63,75,63,63,63,63,63,63,63,63,63,19,19
19,19,63,63,63,63,63,63,63,63,63,63,63,63,63,63,63,63,75,75,75,63,63,63,63,63,63,63,19,19
19,19,63,63,63,63,63,63,63,63,63,63,63,63,63,63,63,63,75,75,75,75,63,63,63,63,63,63,19,19
19,19,63,63,63,63,63,63,63,63,63,63,63,63,63,63,63,75,75,75,75,75,63,63,63,63,63,63,19,19
19,19,63,63,63,121,121,121,121,121,121,121,63,63,63,63,75,75,75,75,75,63,63,63,63,63,63,63,19,19
19,19,63,63,63,121,63,63,63,63,63,121,63,63,63,63,63,75,75,75,75,75,63,63,63,63,63,63,19,19
19,19,63,63,63,121,63,63,63,63,63,121,63,63,63,63,63,63,75,75,63,63,63,63,63,63,63,63,19,19
19,19,63,63,63,121,121,89,77,121,121,121,63,63,63,63,63,63,63,63,63,63,63,63,63,63,63,63,19,19
19,19,63,63,63,63,63,89,77,63,63,63,63,63,63,63,63,63,63,63,63,63,63,63,63,63,63,63,19,19
19,19,63,63,63,63,63,89,77,63,63,63,63,63,63,63,63,63,63,63,63,63,63,63,63,63,63,63,19,19
19,19,63,63,63,63,63,89,77,63,63,63,63,63,63,63,63,63,63,63,63,63,63,63,63,63,63,63,19,19
19,19,63,63,63,63,63,89,77,63,63,63,63,63,63,63,63,63,63,63,63,63,63,63,63,63,63,63,19,19
19,19,63,63,63,63,63,89,77,63,63,63,63,63,63,63,63,63,63,63,63,63,63,63,63,63,63,63,19,19
19,19,63,63,63,63,63,89,77,63,63,63,63,63,63,63,63,63,63,63,63,63,63,63,63,63,63,63,19,19
19,19,19,19,19,19,19,19,19,19,19,19,19,19,19,19,19,19,19,19,19,19,19,19,19,19,19,19,19,19
19,19,19,19,19,19,19,19,19,19,19,19,19,19,19,19,19,19,19,19,19,19,19,19,19,19,19,19,19,19
