30,30
115,115,115,115,115,115,115,115,115,115,115,115,115,115,136,124,115,115,115,115,115,115,115,115,115,115,115,115,115,115
115,63,63,63,63,63,63,63,63,63,63,63,63,63,136,124,63,63,63,63,63,63,63,63,63,63,63,63,63,115
115,63,63,63,63,63,63,63,63,63,63,63,63,63,136,124,63,63,63,63,63,63,63,63,63,63,63,63,63,115
115,63,63,63,63,63,63,63,63,63,63,63,63,63,136,124,63,63,63,63,63,63,63,63,63,63,63,63,63,115
115,63,63,63,63,63,63,63,63,63,63,63,63,63,136,124,63,63,63,63,63,63,63,63,63,63,63,63,63,115
115,63,63,63,63,63,63,63,63,63,63,63,63,63,136,124,63,63,63,63,63,63,63,63,63,63,63,63,63,115
115,63,63,63,63,63,63,63,63,63,63,63,63,63,136,124,63,63,63,63,63,63,63,63,63,63,63,63,63,115
115,63,63,63,63,63,63,63,63,63,63,63,63,63,136,124,63,63,63,63,63,63,63,63,63,63,63,63,63,115
115,63,63,63,63,63,63,63,63,63,63,63,63,63,136,124,63,63,63,63,63,63,63,63,63,63,63,63,63,115
115,63,63,63,63,63,63,63,63,63,63,63,63,63,136,124,63,63,63,63,63,63,63,63,63,63,63,63,63,115
115,63,63,63,63,63,63,63,63,63,63,63,63,63,136,124,63,63,63,63,63,63,63,63,63,63,63,63,63,115
115,63,63,63,63,63,63,63,63,63,63,63,63,63,136,124,63,63,63,63,63,63,63,63,63,63,63,63,63,115
115,63,63,63,63,63,63,63,63,63,63,63,63,63,136,124,63,63,63,63,63,63,63,63,63,63,63,63,63,115
115,63,63,63,63,63,63,63,63,63,63,63,63,63,136,124,63,63,63,63,63,63,63,63,63,63,63,63,63,115
115,63,63,63,63,63,63,63,63,63,63,63,63,63,136,124,63,63,63,63,63,63,63,63,63,63,63,63,63,115
115,63,63,63,63,63,63,63,63,63,63,63,63,63,136,124,63,63,63,63,63,63,63,63,63,63,63,63,63,115
115,63,63,63,63,63,63,63,63,63,63,63,63,63,136,124,63,63,63,63,63,63,63,63,63,63,63,63,63,115
115,63,63,63,63,63,63,63,63,63,63,63,63,63,136,124,63,63,63,63,63,63,63,63,63,63,63,63,63,115
115,63,63,63,63,63,63,63,63,63,63,63,63,63,136,124,63,63,63,63,63,63,63,63,63,63,63,63,63,115
115,63,63,63,63,63,63,63,63,63,63,63,63,63,136,124,63,63,63,63,63,63,63,63,63,63,63,63,63,115
115,63,63,63,63,63,63,63,63,63,63,63,63,63,136,124,63,63,63,63,63,63,63,63,63,63,63,63,63,115
115,63,63,63,63,63,63,63,63,63,63,63,63,63,136,124,63,63,63,63,63,63,63,63,63,63,63,63,63,115
115,63,63,63,63,63,63,63,63,63,63,63,63,63,136,101,112,112,112,112,112,112,112,112,112,112,112,112,112,112
115,63,63,63,63,63,63,63,63,63,63,63,63,63,136,125,100,100,100,100,100,100,100,100,100,100,100,100,100,100
115,63,63,63,63,63,63,63,63,63,63,63,63,63,136,124,63,63,63,63,63,63,63,63,63,63,63,63,63,115
115,63,63,63,63,63,63,63,63,63,63,63,63,63,136,124,63,63,63,63,63,63,63,63,63,63,63,63,63,115
115,63,63,63,63,63,63,63,63,63,63,63,63,63,136,124,63,63,63,63,63,63,63,63,63,63,63,63,63,115
115,63,63,63,63,63,63,63,63,63,63,63,63,63,136,124,63,63,63,63,63,63,63,63,63,63,63,63,63,115
115,63,63,63,63,63,63,63,63,63,63,63,63,63,136,124,63,63,63,63,63,63,63,63,63,63,63,63,63,115
115,115,115,115,115,115,115,115,115,115,115,115,115,115,136,124,115,115,115,115,115,115,115,115,115,115,115,115,115,115
