32,7
9,9,9,9,9,9,9,9,9,9,9,9,9,9,9,9,9,9,9,9,9,9,9,9,9,9,9,9,9,9,9,9
9,9,0,4,12,5,0,4,4,1,0,12,0,12,6,0,12,9,0,4,12,9,9,9,9,9,9,9,9,9,9,9
9,9,2,10,13,6,1,11,7,1,1,10,10,13,6,1,13,9,1,13,4,9,9,9,9,9,9,9,9,9,9,9
9,9,2,7,15,6,1,11,3,1,1,13,12,13,6,1,13,9,3,7,12,9,9,9,9,9,9,9,9,9,9,9
9,9,3,1,6,6,3,11,11,1,3,15,3,15,6,3,15,13,3,7,15,9,9,9,9,9,9,9,9,9,9,9
9,9,9,9,6,9,9,6,6,6,9,6,6,6,6,6,6,9,9,9,9,9,9,9,9,9,9,9,9,9,9,9
9,9,9,9,9,9,9,9,9,9,9,9,9,9,9,9,9,9,9,9,9,9,9,9,9,9,9,9,9,9,9,9
